ZAD	A	RNA LINKING
1MA	A	RNA LINKING
MA6	A	RNA LINKING
SRA	A	RNA LINKING
12A	A	RNA LINKING
2MA	A	RNA LINKING
LCA	A	RNA LINKING
T6A	A	RNA LINKING
MAD	A	RNA LINKING
RIA	A	RNA LINKING
A3P	A	RNA LINKING
A2L	A	RNA LINKING
A23	A	RNA LINKING
8AN	A	RNA LINKING
PU	A	RNA LINKING
6IA	A	RNA LINKING
P5P	A	RNA LINKING
PPU	A	RNA LINKING
5FA	A	RNA LINKING
A2M	A	RNA LINKING
MTU	A	RNA LINKING
A44	A	RNA LINKING
AVC	A	RNA LINKING
MGQ	A	RNA LINKING
AP7	A	RNA LINKING
MIA	A	RNA LINKING
AET	A	RNA LINKING
A5O	A	RNA LINKING
N5M	C	RNA linking
OMC	C	RNA LINKING
10C	C	RNA LINKING
ZCY	C	RNA LINKING
ZBC	C	RNA LINKING
PMT	C	RNA LINKING
M5M	C	RNA LINKING
IC	C	RNA LINKING
S4C	C	RNA LINKING
M4C	C	RNA linking
CBV	C	RNA LINKING
CH	C	RNA LINKING
CCC	C	RNA LINKING
CSF	C	RNA LINKING
C43	C	RNA LINKING
C31	C	RNA LINKING
C2L	C	RNA LINKING
1SC	C	RNA LINKING
A5M	C	RNA LINKING
5IC	C	RNA LINKING
5MC	C	RNA LINKING
4OC	C	RNA LINKING
TPG	G	RNA LINKING
OMG	G	RNA LINKING
1MG	G	RNA LINKING
YYG	G	RNA LINKING
YG	G	RNA LINKING
XTS	G	RNA LINKING
PGP	G	RNA LINKING
23G	G	RNA OH 3 prime terminus
G2L	G	RNA LINKING
2MG	G	RNA LINKING
GRB	G	RNA LINKING
QUO	G	RNA LINKING
ZGU	G	RNA LINKING
M2G	G	RNA LINKING
CG1	G	RNA linking
KAG	G	RNA LINKING
MGV	G	RNA LINKING
IG	G	RNA LINKING
GTP	G	RNA LINKING
GOM	G	RNA LINKING
GH3	G	RNA LINKING
7MG	G	RNA LINKING
G7M	G	RNA LINKING
G46	G	RNA LINKING
G48	G	RNA LINKING
GDP	G	RNA LINKING
G25	G	RNA LINKING
O2G	G	RNA LINKING
GAO	G	RNA LINKING
N6G	G	RNA LINKING
T41	T	RNA LINKING
T38	T	RNA LINKING
T2S	T	RNA LINKING
T23	T	RNA LINKING
SMT	T	RNA LINKING
T39	T	RNA LINKING
ZTH	T	RNA LINKING
UAR	U	RNA LINKING
UR3	U	RNA LINKING
UMP	U	RNA LINKING
4SU	U	RNA LINKING
UD5	U	RNA LINKING
U8U	U	RNA LINKING
U37	U	RNA LINKING
U36	U	RNA LINKING
URD	U	RNA LINKING
US5	U	RNA LINKING
5MU	U	RNA LINKING
125	U	RNA LINKING
OMU	U	RNA LINKING
126	U	RNA LINKING
ZBU	U	RNA LINKING
127	U	RNA LINKING
ONE	U	RNA LINKING
5BU	U	RNA LINKING
70U	U	RNA LINKING
U34	U	RNA LINKING
U31	U	RNA LINKING
5FU	U	RNA LINKING
2OM	U	RNA LINKING
CNU	U	RNA linking
RSQ	U	RNA LINKING
RUS	U	RNA linking
SUR	U	RNA LINKING
SSU	U	RNA LINKING
2MU	U	RNA LINKING
3AU	U	RNA linking
PYO	U	RNA LINKING
2AU	U	RNA LINKING
U2P	U	RNA LINKING
U2L	U	RNA LINKING
IU	U	RNA LINKING
PSU	U	RNA LINKING
3MU	U	RNA LINKING
FHU	U	RNA LINKING
MNU	U	RNA LINKING
H2U	U	RNA LINKING
3TD	U	RNA LINKING
